名前	読み	ローマ字
秋元真夏	あきもと まなつ	akimoto manatsu
生田絵梨花	いくた えりか	ikuta erika
齋藤飛鳥	さいとう あすか	saitou asuka
高山一実	たかやま かずみ	takayama kazumi
樋口日奈	ひぐち ひな	higuchi hina
星野みなみ	ほしの みなみ	hoshino minami
和田まあや	わだ まあや	wada maaya
伊藤純奈	いとう じゅんな	itou jun'na
北野日奈子	きたの ひなこ	kitano hinako
新内眞衣	しんうち まい	shin'uchi mai
鈴木絢音	すずき あやね	suzuki ayane
寺田蘭世	てらだ らんぜ	terada ranze
山崎怜奈	やまざき れな	yamazaki rena
渡辺みり愛	わたなべ みりあ	watanabe miria
伊藤理々杏	いとう りりあ	itou riria
岩本蓮加	いわもと れんか	iwamoto renka
梅澤美波	うめざわ みなみ	umezawa minami
大園桃子	おおぞの ももこ	oozono momoko
久保史緒里	くぼ しおり	kubo shiori
阪口珠美	さかぐち たまみ	sakaguchi tamami
佐藤楓	さとう かえで	satou kaede
中村麗乃	なかむら れの	nakamura reno
向井葉月	むかい はづき	mukai hadzuki
山下美月	やました みづき	yamashita midzuki
吉田綾乃クリスティー	よしだ あやのクリスティー	yoshida ayanokurisutī
与田祐希	よだ ゆうき	yoda yuuki
遠藤さくら	えんどう さくら	endou sakura
賀喜遥香	かき はるか	kaki haruka
掛橋沙耶香	かけはし さやか	kakehashi sayaka
金川紗耶	かながわ さや	kanagawa saya
北川悠理	きたがわ ゆり	kitagawa yuri
黒見明香	くろみ はるか	kuromi haruka
佐藤璃果	さとう りか	satou rika
柴田柚菜	しばた ゆな	shibata yuna
清宮レイ	せいみや れい	seimiya rei
田村真佑	たむら まゆ	tamura mayu
筒井あやめ	つつい あやめ	tsutsui ayame
早川聖来	はやかわ せいら	hayakawa seira
林瑠奈	はやし るな	hayashi runa
松尾美佑	まつお みゆ	matsuo miyu
矢久保美緒	やくぼ みお	yakubo mio
弓木奈於	ゆみき なお	yumiki nao
山本穂乃香	やまもと ほのか	yamamoto honoka
吉本彩華	よしもと あやか	yoshimoto ayaka
岩瀬佑美子	いわせ ゆみこ	iwase yumiko
安藤美雲	あんどう みくも	andou mikumo
柏幸奈	かしわ ゆきな	kashiwa yukina
宮澤成良	みやざわ せいら	miyazawa seira
西川七海	にしかわ ななみ	nishikawa nanami
市來玲奈	いちき れな	ichiki rena
矢田里沙子	やだ りさこ	yada risako
米徳京花	よねとく きょうか	yonetoku kyouka
伊藤寧々	いとう ねね	itou nene
大和里菜	やまと りな	yamato rina
畠中清羅	はたなか せいら	hatanaka seira
松井玲奈	まつい れな	matsui rena
永島聖羅	ながしま せいら	nagashima seira
深川麻衣	ふかがわ まい	fukagawa mai
橋本奈々未	はしもと ななみ	hashimoto nanami
中元日芽香	なかもと ひめか	nakamoto himeka
伊藤万理華	いとう まりか	itou marika
川村真洋	かわむら まひろ	kawamura mahiro
生駒里奈	いこま りな	ikoma rina
斎藤ちはる	さいとう ちはる	saitou chiharu
相楽伊織	さがら いおり	sagara iori
若月佑美	わかつき ゆみ	wakatsuki yumi
能條愛未	のうじょう あみ	noujou ami
川後陽菜	かわご ひな	kawago hina
西野七瀬	にしの ななせ	nishino nanase
衛藤美彩	えとう みさ	etou misa
伊藤かりん	いとう かりん	itou karin
斉藤優里	さいとう ゆうり	saitou yuuri
桜井玲香	さくらい れいか	sakurai reika
佐々木琴子	ささき ことこ	sasaki kotoko
井上小百合	いのうえ さゆり	inoue sayuri
中田花奈	なかだ かな	nakada kana
白石麻衣	しらいし まい	shiraishi mai
堀未央奈	ほり みおな	hori miona
松村沙友理	まつむら さゆり	matsumura sayuri
